0100000010
0100000010
0111111110
1000000001
1001001001
1000000001
1000110001
1000000001
0111111110
